................................
................................
................................
................................
................................
................................
................................
................................
................................
................................
................................
................................
................................
................................
................................
...................###..........
................................
................................
............###.................
................................
...............................#
................................
................................
################################