################################
#..............................#
##.............................#
#####.....................######
#####.....................######
#####.....................######
#####.........................##
#####.....................######
#####........................###
#####.....................######
#...#.........................##
#####.....................######
#####.....................######
#####.....................######
#####.........................##
##........................#...##
#####.....................######
#####.....................######
#####........###..........######
#...........................####
#.............................##
#............................###
................................
################################